0 0 0 0 0 0
0 5 3 5 3 0
0 1 5 3 0 0
0 2 3 5 1 0
0 6 1 1 5 0
0 1 5 5 1 5
0 0 0 0 0 0